R 1920 1080 
NO         ./textures/wood.xpm
SO ./textures/bluestone.xpm
WE ./textures/colorstone.xpm
EA ./textures/redbrick.xpm
S ./textures/barrel.xpm
F 255,10,10
C 10,255,10

111111111111111111111111111111111111111111111111
1000002000000000000000000W1000000000000000000001
1111111100000011111010101111111000000000000
100000000000000000000000000000000001000000001001
111100000000000000000000000002020000000002000101
100000000000000000000000010000000000000000000001
111111111111111111111111111111111111111111111111