R     1000 550
NO      ./textures/eagle.xpm

SO  ./textures/redbrick.xpm

F 5316546846,2,255



WE              ./textures/mossy.xpm

EA        ./textures/greystone.xpm

S                     ./textures/barrel.xpm



C 10,255,10

111111111111111111111111111111111
1E000020000000000000000  00000001
100000000000000000000000000000001
100020001111000010000000000000001
100000100000000000000000000000001
111000000  000011000000000 000001
100000000000000010000000000000001
100000000000000000000000000000001
11020000000000001000000 000000001
100000000000000000000000000000001
11000000000000001000   1000000001
111111111111111111111111111111111