R      1920 1080 
NO    ./textures/eagle.xpm
SO             ./textures/red.xpm
WE         ./textures/purplestone.xpm
EA   ./textures/greystone.xpm
S                ./textures/barrelxpm
F 255,10,10
C 10,255,10

11111111
1E000021
100Z0001
10002001
10000021
11111111