R 1920 1080

NO         ./textures/wood.xpm
SO ./textures/bluestone.xpm
WE ./textures/colorstone.xpm
EA ./textures/redbrick.xpm
S ./textures/barrel.xpm

F  220,10,255 
C  2  ,  30  ,  100

 111111111111111111 
 1200000000000000001
 100000000000000001
 100000002000000021
 100000000000000201
 100000000000000001
 100000W000000000 1
 100000000000000001
 111111111111111111


