R 1920 1080

NO ./textures/wood.xpm
SO ./textures/bluestone.xpm
WE ./textures/colorstone.xpm
EA ./textures/redbrick.xpm
S ./textures/barrel.xpm


F   2 , 30 ,  110   
C   225, 30,110

11111111111111111111111111111
100000N0001100000000000000001
10110000011100000000000010001
10010000000000000000000010001
10110000011100000000000010001
10000000001100000111011110001
11110111111111011100000010001
11110111111111011101010010001
11000000110101011100000010001
10000000000000001100000010001
10000000000000001102010020001
11000000110102222000000000001
11110111110101000000202000001
10000000001100000100000010001
10000000000000002000200001001
10000000001000010000000001001
10000000001101000000000000001
10000000000100000001010000001
11111111111111111111111111111