R 960 540

NO ./textures/bluestone.xpm
SO ./textures/wood.xpm
WE ./textures/redbrick.xpm
EA ./textures/colorstone.xpm
S  ./textures/barrel.xpm

F 220,10,10
C 225,30,100


1111111111111111111111111
1000000000110000000000001
1011000000020000000000001
1001000000000000222200001
111000000000000022222000111111111
11100000S0000000222222000000001111
111100000000000000000000111111
1111000000000000000000001
1100000000000002000000001
1002000000000000000000001
1000000000000000000000001
1100000000000000000000111
1111000000000000000111111
1111111111111111111111111
